indifference - obojętność na;
be indifferent to - być obojętnym na;
appeal for/call for - wzywać/apelować;
surrounded by - otoczony przez;
empire/kingdom - królestwo;
footage - materiał filmowy;
bring about/to cause - wywołać coś;
by carefull what you wish - uważaj czego sobie życzysz;
every cloud has a silver lining - nie ma tego złego co by na dobre nie wyszło;
silver lining - światełko nadziei;
boarding pass - karta pokładowa;
grab - chwycić;
gear - sprzęt;
enjoy the peace and quiet - cieszyć się spokojem i ciszą;
highlight your best features - podkreślić twoje najlepsze cechy;
rehearsals - próby;
get descructed - rozproszyć kogoś;
appeal to sbd - podobać się komuś;
overcome personal issues - pokonać osobiste problemy;
stage fright - trema;
pretend to be - udawać że jest się;
play - sztuka np. teatralna;
the harder sth is the more satysfying the reward can be - im coś jest cięższe tym bardziej satysfakcjonujaca może być nagroda;
the more you give the more you get - więcej dajesz to więcej dostajesz;
I go through - przejść przez;
extra ordinary experience - specjalne doświadczenie;
fool around - wygłupiać się;
undoubtedly - bez wątpienia;
u had me in the palm of ur hand - miałeś mnie jak na dłoni;
breathe - oddychać;
breath - oddech;
impactful - wpływowy
|
inconvenience - niedogodność;
withdraw - wycofać się;
to withdraw money - wypłacić pieniądze;
withdrawal - wypłata/wycofanie;
anxious - zmartwiony;
anxiety - zmartwienie;
item - przedmiot;
leave behind - pozostawić;
belongings - rzeczy osobiste;
removal/moving company - firma przeprowadzkowa;
reluctent/unwilling - niechętny;
tap - kran;
confirm - potwierdzić;
delivery time - czas dostarczania;
werehouse/storage - magazyn;
leak - przeciekać;
damp - wilgotny;
estimated - czacowany;
on schedule - według rozkładu;
appointed time - umówiony czas;
show up - pojawić się;
show off - popisywać się;
turned out - okazało się;
make a complaint - złożyć skargę;
apparently - najwidoczniej;
charge fee - pobrać opłatę;
there was no point in - nie było żadnego sensu
|
turned out - okazało się;
five-star hotel - hotel pięcio-gwiazdkowy;
west bank of the river - zachodni brzeg rzeki;
make sth out - poradzić sobie z;
flood - powódź;
drought - susza;
avalanche - lawina;
vulcano eruption - erupcja wulkanu;
stretcher - nosze;
crutches - kule;
weelchair - wózek;
artificial leg - sztuczna noga;
narrow - wąski;
wide - szeroki;
painkillers - tabletki przeciwbólowe;
witty - dowcipny/błyskotliwy;
well aware - świadomy;
cuisine - kichnia;
curious - ciekawy;
eager - chętny/ochoczy;
careless - niedbały;
thrilling - ekscytujący;
cautious - ostrożny;
throughout - na wskroś/terenie;
approximate - przybliżony;
attitude - podejście;
commuter - dojeżdżający;
stop - sheet;
bring about - spowodować coś